######################
            ##  ##  ##
##  ##########  ##  ##
##                  ##
##  ##  ##########  ##
##  ##          ##  ##
##  ##  ##  ######  ##
##  ##  ##      ##  ##
##  ##  ##  ##  ##    
##  ##  ##  ##  ##  ##
######################
